111111
100001
100011
1001E1
111111
