11111111
100E0001
1000C001
100000P
1C000001
11111111
