1111       111111111
10P1       1000000011
1001  100110011111001
1001  100111111111001
100111100111000000011
100000000000011111111
10000C0001100000000011
1111111001111111110001
    100111       1E1
    1111         111
