11111111111111111111111111111111111111
1C0000000000000000000000000000000000E1
10000000000C00000000000000000000000001
10000000000000000000000000000000000001
10000000000000000000000000000000000001
10000000000000000CCC000000000000000001
100000000000000000000000000C0000000001
10000000000000000000000000000000000001
10000000000000000000000000000000000001
10000000000000000000000000000000000001
10000000000000000000C0000000000000C001
10000000000000000000000000000000000001
10000000000000000000000000000000000001
10000000000000000000000000000000000001
10000000000000000000000000000000000001
10000000000000000000000000000000000001
10000000000000000000000000000000000001
1000000000C00000000000000000000000C001
10P000000000000000000000000000000000B1
11111111111111111111111111111111111111
