111111111111111111111111111111111111
10P0100001000000000000C0010000000001
100100000100000000000000000E00100001
1010000000000000C0000000011111100001
1000000001000000000000000C00001000C1
100000000100000001110000000000100001
1000000C0000000C00000000000000100001
111111111101100011011000000111100001
100000001000000000100000100000000001
1000000001000000000000000000001C0001
1000000000000000C0000000011111100001
1000000001000000000000000000001000C1
100000000100000000000000000000100001
1000000C0000000C000000000000000B0001
111111111111111111111111111111111111
