111111111111111111111111111111111111111
10C00000000000000C0000000000000000000E1
100100000100000000000000000000C00000001
100100000000000000000000000000000000001
1C0100000100000000000C00000000000000001
10C100000000000000000000000000000000001
100100000000000000000000000000000000001
100100000000000000000000100000000000001
1001000000000000C0000000100000000000001
1C0100000000000000000000100000000000001
100100000100000000000000000000000000111
100100000000000000000000000000000000001
100100000000000000000000000100000000001
100100000000000000000000000000000000001
10010000000000C00000000000000000C000001
100100000000000000000000000000000000001
100100000000000000000000000000000000001
100100000000000000000000000C00000000001
10P1000000000000000000000000000000C00B1
111111111111111111111111111111111111111
